6 6 6 6 6 6 6 6 6 6 6 6 6 6 6 6 6 6 -1
6 6 6 6 6 6 6 6 6 6 6 6 6 6 6 6 6 6 -1
6 6 6 6 6 6 6 6 6 6 6 6 6 6 6 6 6 6 -1
6 6 6 4 4 4 4 4 4 4 4 4 4 4 4 6 6 6 -1
6 6 6 4 4 4 4 4 4 4 4 4 4 4 4 6 6 6 -1
6 6 6 4 4 4 4 4 7 7 4 4 4 4 4 6 6 6 -1
6 6 6 4 4 4 4 4 4 4 4 4 4 4 4 6 6 6 -1
6 6 6 4 4 4 4 4 4 4 4 4 4 4 4 6 6 6 -1
6 6 6 4 4 4 4 4 4 4 4 4 4 4 4 6 6 6 -1
6 6 6 4 4 4 4 4 4 4 4 4 4 4 4 6 6 6 -1
6 6 6 4 4 4 4 4 4 4 4 4 4 4 4 6 6 6 -1
6 6 6 4 4 4 4 4 4 4 4 4 4 4 4 6 6 6 -1
6 6 6 4 4 4 4 4 4 4 4 4 4 4 4 6 6 6 -1
6 6 6 4 4 4 4 4 4 4 4 4 4 4 4 6 6 6 -1
6 6 6 4 4 4 4 4 4 4 4 4 4 4 4 6 6 6 -1
6 6 6 6 6 6 6 6 6 6 6 6 6 6 6 6 6 6 -1
6 6 6 6 6 6 6 6 6 6 6 6 6 6 6 6 6 6 -1
6 6 6 6 6 6 6 6 6 6 6 6 6 6 6 6 6 6
-2
2 2 2 2 2 2 2 2 2 2 2 2 2 2 2 2 2 2 -1
2 2 2 2 2 2 2 2 2 2 2 2 2 2 2 2 2 2 -1
2 2 2 2 2 2 2 2 2 2 2 2 2 2 2 2 2 2 -1
2 2 2 3 3 3 3 3 3 3 3 3 3 3 3 2 2 2 -1
2 2 2 3 0 0 0 5 5 5 5 0 0 0 3 2 2 2 -1
2 2 2 3 0 0 0 5 0 0 5 0 0 0 3 2 2 2 -1
2 2 2 3 0 0 0 0 0 0 0 0 0 0 3 2 2 2 -1
2 2 2 3 0 0 0 0 0 0 0 0 0 0 3 2 2 2 -1
2 2 2 3 0 0 0 0 0 0 0 0 0 0 3 2 2 2 -1
2 2 2 3 0 0 0 0 0 0 0 0 0 0 3 2 2 2 -1
2 2 2 3 0 0 0 0 0 0 0 0 0 0 3 2 2 2 -1
2 2 2 3 0 0 0 0 0 0 0 0 0 0 3 2 2 2 -1
2 2 2 3 0 0 0 0 0 0 0 0 0 0 3 2 2 2 -1
2 2 2 3 0 0 0 0 0 0 0 0 0 0 3 2 2 2 -1
2 2 2 3 3 3 3 3 0 0 3 3 3 3 3 2 2 2 -1
2 2 2 2 2 2 2 2 2 2 2 2 2 2 2 2 2 2 -1
2 2 2 2 2 2 2 2 2 2 2 2 2 2 2 2 2 2 -1
2 2 2 2 2 2 2 2 2 2 2 2 2 2 2 2 2 2
-2
0 0 0 0 0 0 0 0 0 0 0 0 0 0 0 -1
0 0 0 0 0 0 0 0 0 0 0 0 0 0 0 -1
0 0 0 0 0 0 0 0 0 0 0 0 0 0 0 -1
0 0 0 3 3 3 3 3 3 3 3 3 3 3 3 -1
0 0 0 3 0 0 0 5 5 5 5 0 0 0 3 -1
0 0 0 3 0 0 0 5 0 0 5 0 0 0 3 -1
0 0 0 1 0 0 0 0 0 0 0 0 0 0 1 -1
0 0 0 1 0 0 0 0 0 0 0 0 0 0 1 -1
0 0 0 1 0 0 0 0 0 0 0 0 0 0 1 -1
0 0 0 1 0 0 0 0 0 0 0 0 0 0 1 -1
0 0 0 1 0 0 0 0 0 0 0 0 0 0 1 -1
0 0 0 1 0 0 0 0 0 0 0 0 0 0 1 -1
0 0 0 3 0 0 0 0 0 0 0 0 0 0 3 -1
0 0 0 3 0 0 0 0 0 0 0 0 0 0 3 -1
0 0 0 3 3 3 1 3 0 0 3 1 3 3 3
-2
0 0 0 0 0 0 0 0 0 0 0 0 0 0 0 -1
0 0 0 0 0 0 0 0 0 0 0 0 0 0 0 -1
0 0 0 0 0 0 0 0 0 0 0 0 0 0 0 -1
0 0 0 3 3 3 3 3 3 3 3 3 3 3 3 -1
0 0 0 3 0 0 0 0 5 5 0 0 0 0 3 -1
0 0 0 3 0 0 0 0 5 5 0 0 0 0 3 -1
0 0 0 3 0 0 0 0 0 0 0 0 0 0 3 -1
0 0 0 3 0 0 0 0 0 0 0 0 0 0 3 -1
0 0 0 3 0 0 0 0 0 0 0 0 0 0 3 -1
0 0 0 3 0 0 0 0 0 0 0 0 0 0 3 -1
0 0 0 3 0 0 0 0 0 0 0 0 0 0 3 -1
0 0 0 3 0 0 0 0 0 0 0 0 0 0 3 -1
0 0 0 3 0 0 0 0 0 0 0 0 0 0 3 -1
0 0 0 3 0 0 0 0 0 0 0 0 0 0 3 -1
0 0 0 3 3 3 3 3 3 3 3 3 3 3 3
-2
0 0 0 0 0 0 0 0 0 0 0 0 0 0 0 -1
0 0 0 0 0 0 0 0 0 0 0 0 0 0 0 -1
0 0 0 0 0 0 0 0 0 0 0 0 0 0 0 -1
0 0 0 3 3 3 3 3 3 3 3 3 3 3 3 -1
0 0 0 3 0 0 0 0 5 5 0 0 0 0 3 -1
0 0 0 3 0 0 0 0 5 5 0 0 0 0 3 -1
0 0 0 3 0 0 0 0 0 0 0 0 0 0 3 -1
0 0 0 3 0 0 0 0 0 0 0 0 0 0 3 -1
0 0 0 3 0 0 0 0 0 0 0 0 0 0 3 -1
0 0 0 3 0 0 0 0 0 0 0 0 0 0 3 -1
0 0 0 3 0 0 0 0 0 0 0 0 0 0 3 -1
0 0 0 3 0 0 0 0 0 0 0 0 0 0 3 -1
0 0 0 3 0 0 0 0 0 0 0 0 0 0 3 -1
0 0 0 3 0 0 0 0 0 0 0 0 0 0 3 -1
0 0 0 3 3 3 3 3 3 3 3 3 3 3 3
-2
0 0 0 0 0 0 0 0 0 0 0 0 0 0 0 -1
0 0 0 0 0 0 0 0 0 0 0 0 0 0 0 -1
0 0 0 0 0 0 0 0 0 0 0 0 0 0 0 -1
0 0 0 3 3 3 3 3 3 3 3 3 3 3 3 -1
0 0 0 3 0 0 0 0 5 5 0 0 0 0 3 -1
0 0 0 3 0 0 0 0 5 5 0 0 0 0 3 -1
0 0 0 1 0 0 0 0 0 0 0 0 0 0 1 -1
0 0 0 1 0 0 0 0 0 0 0 0 0 0 1 -1
0 0 0 1 0 0 0 0 0 0 0 0 0 0 1 -1
0 0 0 1 0 0 0 0 0 0 0 0 0 0 1 -1
0 0 0 1 0 0 0 0 0 0 0 0 0 0 1 -1
0 0 0 1 0 0 0 0 0 0 0 0 0 0 1 -1
0 0 0 3 0 0 0 0 0 0 0 0 0 0 3 -1
0 0 0 3 0 0 0 0 0 0 0 0 0 0 3 -1
0 0 0 3 3 3 1 1 1 1 1 1 3 3 3
-2
0 0 0 0 0 0 0 0 0 0 0 0 0 0 0 -1
0 0 0 0 0 0 0 0 0 0 0 0 0 0 0 -1
0 0 0 0 0 0 0 0 0 0 0 0 0 0 0 -1
0 0 0 3 3 3 3 3 3 3 3 3 3 3 3 -1
0 0 0 3 0 0 0 0 5 5 0 0 0 0 3 -1
0 0 0 3 0 0 0 0 5 5 0 0 0 0 3 -1
0 0 0 3 0 0 0 0 0 0 0 0 0 0 3 -1
0 0 0 3 0 0 0 0 0 0 0 0 0 0 3 -1
0 0 0 3 0 0 0 0 0 0 0 0 0 0 3 -1
0 0 0 3 0 0 0 0 0 0 0 0 0 0 3 -1
0 0 0 3 0 0 0 0 0 0 0 0 0 0 3 -1
0 0 0 3 0 0 0 0 0 0 0 0 0 0 3 -1
0 0 0 3 0 0 0 0 0 0 0 0 0 0 3 -1
0 0 0 3 0 0 0 0 0 0 0 0 0 0 3 -1
0 0 0 3 3 3 3 3 3 3 3 3 3 3 3
-2
0 0 0 0 0 0 0 0 0 0 0 0 0 0 0 -1
0 0 0 0 0 0 0 0 0 0 0 0 0 0 0 -1
0 0 0 0 0 0 0 0 0 0 0 0 0 0 0 -1
0 0 0 3 3 3 3 3 3 3 3 3 3 3 3 -1
0 0 0 3 0 0 0 0 5 5 0 0 0 0 3 -1
0 0 0 3 0 0 0 0 5 5 0 0 0 0 3 -1
0 0 0 3 0 0 0 0 0 0 0 0 0 0 3 -1
0 0 0 3 0 0 0 0 0 0 0 0 0 0 3 -1
0 0 0 3 0 0 0 0 0 0 0 0 0 0 3 -1
0 0 0 3 0 0 0 0 0 0 0 0 0 0 3 -1
0 0 0 3 0 0 0 0 0 0 0 0 0 0 3 -1
0 0 0 3 0 0 0 0 0 0 0 0 0 0 3 -1
0 0 0 3 0 0 0 0 0 0 0 0 0 0 3 -1
0 0 0 3 0 0 0 0 0 0 0 0 0 0 3 -1
0 0 0 3 3 3 3 3 3 3 3 3 3 3 3
-2
0 0 0 0 0 0 0 0 0 0 0 0 0 0 0 -1
0 0 0 0 0 0 0 0 0 0 0 0 0 0 0 -1
0 0 0 0 0 0 0 0 0 0 0 0 0 0 0 -1
0 0 0 3 3 3 3 3 3 3 3 3 3 3 3 -1
0 0 0 3 0 0 0 0 5 5 0 0 0 0 3 -1
0 0 0 3 0 0 0 0 5 5 0 0 0 0 3 -1
0 0 0 1 0 0 0 0 0 0 0 0 0 0 1 -1
0 0 0 1 0 0 0 0 0 0 0 0 0 0 1 -1
0 0 0 1 0 0 0 0 0 0 0 0 0 0 1 -1
0 0 0 1 0 0 0 0 0 0 0 0 0 0 1 -1
0 0 0 1 0 0 0 0 0 0 0 0 0 0 1 -1
0 0 0 1 0 0 0 0 0 0 0 0 0 0 1 -1
0 0 0 3 0 0 0 0 0 0 0 0 0 0 3 -1
0 0 0 3 0 0 0 0 0 0 0 0 0 0 3 -1
0 0 0 3 3 3 1 1 1 1 1 1 3 3 3
-2
0 0 0 0 0 0 0 0 0 0 0 0 0 0 0 -1
0 0 0 0 0 0 0 0 0 0 0 0 0 0 0 -1
0 0 0 0 0 0 0 0 0 0 0 0 0 0 0 -1
0 0 0 3 3 3 3 3 3 3 3 3 3 3 3 -1
0 0 0 3 0 0 0 0 5 5 0 0 0 0 3 -1
0 0 0 3 0 0 0 0 5 5 0 0 0 0 3 -1
0 0 0 3 0 0 0 0 0 0 0 0 0 0 3 -1
0 0 0 3 0 0 0 0 0 0 0 0 0 0 3 -1
0 0 0 3 0 0 0 0 0 0 0 0 0 0 3 -1
0 0 0 3 0 0 0 0 0 0 0 0 0 0 3 -1
0 0 0 3 0 0 0 0 0 0 0 0 0 0 3 -1
0 0 0 3 0 0 0 0 0 0 0 0 0 0 3 -1
0 0 0 3 0 0 0 0 0 0 0 0 0 0 3 -1
0 0 0 3 0 0 0 0 0 0 0 0 0 0 3 -1
0 0 0 3 3 3 3 3 3 3 3 3 3 3 3
-2
0 0 0 0 0 0 0 0 0 0 0 0 0 0 0 -1
0 0 0 0 0 0 0 0 0 0 0 0 0 0 0 -1
0 0 0 0 0 0 0 0 0 0 0 0 0 0 0 -1
0 0 0 3 3 3 3 3 3 3 3 3 3 3 3 -1
0 0 0 3 0 0 0 0 5 5 0 0 0 0 3 -1
0 0 0 3 0 0 0 0 5 5 0 0 0 0 3 -1
0 0 0 3 0 0 0 0 0 0 0 0 0 0 3 -1
0 0 0 3 0 0 0 0 0 0 0 0 0 0 3 -1
0 0 0 3 0 0 0 0 0 0 0 0 0 0 3 -1
0 0 0 3 0 0 0 0 0 0 0 0 0 0 3 -1
0 0 0 3 0 0 0 0 0 0 0 0 0 0 3 -1
0 0 0 3 0 0 0 0 0 0 0 0 0 0 3 -1
0 0 0 3 0 0 0 0 0 0 0 0 0 0 3 -1
0 0 0 3 0 0 0 0 0 0 0 0 0 0 3 -1
0 0 0 3 3 3 3 3 3 3 3 3 3 3 3
-2
0 0 0 0 0 0 0 0 0 0 0 0 0 0 0 0 -1
0 0 0 0 0 0 0 0 0 0 0 0 0 0 0 0 -1
0 0 3 3 3 3 3 3 3 3 3 3 3 3 3 3 -1
0 0 3 0 0 0 0 0 0 0 0 0 0 0 0 3 -1
0 0 3 0 0 0 0 0 5 5 0 0 0 0 0 3 -1
0 0 3 0 0 0 0 0 5 5 0 0 0 0 0 3 -1
0 0 3 0 0 0 0 0 0 0 0 0 0 0 0 3 -1
0 0 3 0 0 0 0 0 0 0 0 0 0 0 0 3 -1
0 0 3 0 0 0 0 0 0 0 0 0 0 0 0 3 -1
0 0 3 0 0 0 0 0 0 0 0 0 0 0 0 3 -1
0 0 3 0 0 0 0 0 0 0 0 0 0 0 0 3 -1
0 0 3 0 0 0 0 0 0 0 0 0 0 0 0 3 -1
0 0 3 0 0 0 0 0 0 0 0 0 0 0 0 3 -1
0 0 3 0 0 0 0 0 0 0 0 0 0 0 0 3 -1
0 0 3 0 0 0 0 0 0 0 0 0 0 0 0 3 -1
0 0 3 3 3 3 3 3 3 3 3 3 3 3 3 3
-2
0 0 0 0 0 0 0 0 0 0 0 0 0 0 0 -1
0 0 0 0 0 0 0 0 0 0 0 0 0 0 0 -1
0 0 0 0 0 0 0 0 0 0 0 0 0 0 0 -1
0 0 0 3 3 3 3 3 3 3 3 3 3 3 3 -1
0 0 0 3 0 0 0 0 5 5 0 0 0 0 3 -1
0 0 0 3 0 0 0 0 5 5 0 0 0 0 3 -1
0 0 0 3 0 0 0 0 0 0 0 0 0 0 3 -1
0 0 0 3 0 0 0 0 0 0 0 0 0 0 3 -1
0 0 0 3 0 0 0 0 0 0 0 0 0 0 3 -1
0 0 0 3 0 0 0 0 0 0 0 0 0 0 3 -1
0 0 0 3 0 0 0 0 0 0 0 0 0 0 3 -1
0 0 0 3 0 0 0 0 0 0 0 0 0 0 3 -1
0 0 0 3 0 0 0 0 0 0 0 0 0 0 3 -1
0 0 0 3 0 0 0 0 0 0 0 0 0 0 3 -1
0 0 0 3 3 3 3 3 3 3 3 3 3 3 3
-2
0 0 0 0 0 0 0 0 0 0 0 0 0 0 0 -1
0 0 0 0 0 0 0 0 0 0 0 0 0 0 0 -1
0 0 0 0 0 0 0 0 0 0 0 0 0 0 0 -1
0 0 0 0 0 0 0 0 0 0 0 0 0 0 0 -1
0 0 0 0 3 3 3 3 5 5 3 3 3 3 0 -1
0 0 0 0 3 0 0 0 5 5 0 0 0 3 0 -1
0 0 0 0 3 0 0 0 0 0 0 0 0 3 0 -1
0 0 0 0 3 0 0 0 0 0 0 0 0 3 0 -1
0 0 0 0 3 0 0 0 0 0 0 0 0 3 0 -1
0 0 0 0 3 0 0 0 0 0 0 0 0 3 0 -1
0 0 0 0 3 0 0 0 0 0 0 0 0 3 0 -1
0 0 0 0 3 0 0 0 0 0 0 0 0 3 0 -1
0 0 0 0 3 0 0 0 0 0 0 0 0 3 0 -1
0 0 0 0 3 3 3 3 3 3 3 3 3 3 0 -1
0 0 0 0 0 0 0 0 0 0 0 0 0 0 0
-2
0 0 0 0 0 0 0 0 0 0 0 0 0 0 0 -1
0 0 0 0 0 0 0 0 0 0 0 0 0 0 0 -1
0 0 0 0 0 0 0 0 0 0 0 0 0 0 0 -1
0 0 0 0 0 0 0 0 0 0 0 0 0 0 0 -1
0 0 0 0 0 0 0 0 5 5 0 0 0 0 0 -1
0 0 0 0 0 3 3 3 5 5 3 3 3 0 0 -1
0 0 0 0 0 3 0 0 0 0 0 0 3 0 0 -1
0 0 0 0 0 3 0 0 0 0 0 0 3 0 0 -1
0 0 0 0 0 3 0 0 0 0 0 0 3 0 0 -1
0 0 0 0 0 3 0 0 0 0 0 0 3 0 0 -1
0 0 0 0 0 3 0 0 0 0 0 0 3 0 0 -1
0 0 0 0 0 3 0 0 0 0 0 0 3 0 0 -1
0 0 0 0 0 3 3 3 3 3 3 3 3 0 0 -1
0 0 0 0 0 0 0 0 0 0 0 0 0 0 0 -1
0 0 0 0 0 0 0 0 0 0 0 0 0 0 0
-2
0 0 0 0 0 0 0 0 0 0 0 0 0 0 0 -1
0 0 0 0 0 0 0 0 0 0 0 0 0 0 0 -1
0 0 0 0 0 0 0 0 0 0 0 0 0 0 0 -1
0 0 0 0 0 0 0 0 0 0 0 0 0 0 0 -1
0 0 0 0 0 0 0 0 5 5 0 0 0 0 0 -1
0 0 0 0 0 0 0 0 5 5 0 0 0 0 0 -1
0 0 0 0 0 0 3 3 3 3 3 3 0 0 0 -1
0 0 0 0 0 0 3 0 0 0 0 3 0 0 0 -1
0 0 0 0 0 0 3 0 0 0 0 3 0 0 0 -1
0 0 0 0 0 0 3 0 0 0 0 3 0 0 0 -1
0 0 0 0 0 0 3 0 0 0 0 3 0 0 0 -1
0 0 0 0 0 0 3 3 3 3 3 3 0 0 0 -1
0 0 0 0 0 0 0 0 0 0 0 0 0 0 0 -1
0 0 0 0 0 0 0 0 0 0 0 0 0 0 0 -1
0 0 0 0 0 0 0 0 0 0 0 0 0 0 0
-2
0 0 0 0 0 0 0 0 0 0 0 0 0 0 0 -1
0 0 0 0 0 0 0 0 0 0 0 0 0 0 0 -1
0 0 0 0 0 0 0 0 0 0 0 0 0 0 0 -1
0 0 0 0 0 0 0 0 0 0 0 0 0 0 0 -1
0 0 0 0 0 0 0 0 5 5 0 0 0 0 0 -1
0 0 0 0 0 0 0 0 5 5 0 0 0 0 0 -1
0 0 0 0 0 0 0 0 0 0 0 0 0 0 0 -1
0 0 0 0 0 0 0 3 3 3 3 0 0 0 0 -1
0 0 0 0 0 0 0 3 3 3 3 0 0 0 0 -1
0 0 0 0 0 0 0 3 3 3 3 0 0 0 0 -1
0 0 0 0 0 0 0 3 3 3 3 0 0 0 0 -1
0 0 0 0 0 0 0 0 0 0 0 0 0 0 0 -1
0 0 0 0 0 0 0 0 0 0 0 0 0 0 0 -1
0 0 0 0 0 0 0 0 0 0 0 0 0 0 0 -1
0 0 0 0 0 0 0 0 0 0 0 0 0 0 0
-2